=LoginServlet
registrationPage=registration.jsp
registNewAccount=RegistNewAccountServlet
viewSubjectPage=viewSubject.jsp
searchQuestion=SearchServlet
createQuestion=CreateServlet
loginPage=login.html
errorPage=error.html
logout=LogoutServlet
viewQuestion=ViewQuestionServlet
takeQuiz=TakeQuizServlet
viewQuestionPage=viewQuestion.jsp
update=UpdateQuestionServlet
delete=DeleteQuestionServlet
updatePage=update.jsp
confirm=ConfirmServlet
create=CreateQuestionServlet
createPage=create.jsp
takeQuiz=TakeQuizServlet
takeQuizPage=takeQuiz.jsp
finish=FinishServlet
viewPointPage=viewPoint.jsp
search=SearchServlet
viewHistory=ViewHistoryServlet
viewHistoryPage=viewHistory.jsp
searchHistory=SearchHistoryServlet
createQuizPage=createQuiz.jsp
createQuiz=CreateQuizServlet
viewHistoryDetail=ViewHistoryDetailServlet
viewHistoryDetailPage=viewHistoryDetail.jsp